10.ox
..6...1...
....o...o.
...o..o..o
.o..o...o.
...4.....o
......o...
..5.ooo.o.
.....o.o..
...o..o...
..d.x..ooo
