10.ox
oo...o...o
..o.o.......
..........
...o...o.ooo..
ooo.....o.
.....o..o.
o.....o...
.o....o...
.........o
..........
